############:############
############:############
############:############
############a------------
#########################
#########################
^^^^^^^^^^^^^^^^^^^^^^^^^
=========================
vvvvvvvvvvvvvvvvvvvvvvvvv
#########################
#########################
#########################
#########################
#########################
#########################
